5
30 25
0 0 0 0 0 0 0 0 0 0 0 0 0 0 0 0 0 0 0 0 0 0 0 0 0
0 0 0 0 0 0 0 0 0 0 0 0 0 0 0 0 0 0 0 0 0 0 0 0 0
0 0 0 0 0 0 0 0 0 0 0 0 0 0 0 0 0 0 0 0 0 0 0 0 0
0 0 0 0 0 0 0 0 0 0 0 0 0 0 0 0 0 0 0 0 0 0 0 0 0
0 0 0 0 0 0 0 0 0 0 0 0 0 0 0 0 0 0 0 0 0 0 0 0 0
0 0 0 0 0 0 0 1 1 1 1 1 1 1 1 1 1 1 0 0 0 0 0 0 0
0 0 0 0 0 0 0 2 3 2 3 4 5 6 2 3 2 3 0 0 0 0 0 0 0
0 0 0 0 0 0 0 7 8 7 8 9 10 11 7 8 7 8 0 0 0 0 0 0 0
0 0 0 0 0 0 0 12 12 12 12 12 12 12 12 12 12 12 0 0 0 0 0 0 0
0 0 0 0 0 0 0 13 13 13 13 13 13 13 13 13 13 13 0 0 0 0 0 0 0
0 0 0 0 0 0 0 13 13 13 13 13 13 13 13 13 13 13 0 0 0 0 0 0 0
0 0 0 0 0 0 0 13 13 13 14 15 15 15 16 13 13 13 0 0 0 0 0 0 0
0 0 0 0 0 0 0 13 13 13 17 13 13 13 18 13 13 13 0 0 0 0 0 0 0
0 0 0 0 0 0 0 19 20 13 17 13 13 13 18 13 21 19 0 0 0 0 0 0 0
0 0 0 0 0 0 0 22 23 13 17 24 25 26 18 13 27 22 0 0 0 0 0 0 0
0 0 0 0 0 0 0 28 29 13 30 31 32 33 34 13 35 28 0 0 0 0 0 0 0
0 0 0 0 0 0 0 36 37 13 17 38 39 40 18 13 41 36 0 0 0 0 0 0 0
0 0 0 0 0 0 0 42 43 13 17 44 45 46 18 13 47 42 0 0 0 0 0 0 0
0 0 0 0 0 0 0 13 13 13 17 13 13 13 18 13 13 13 0 0 0 0 0 0 0
0 0 0 0 0 0 0 13 13 13 17 13 13 13 18 13 13 13 0 0 0 0 0 0 0
0 0 0 0 0 0 0 13 13 13 48 49 49 49 50 13 13 13 0 0 0 0 0 0 0
0 0 0 0 0 0 0 13 13 13 13 13 13 13 13 13 13 13 0 0 0 0 0 0 0
0 0 0 0 0 0 0 13 13 13 13 13 13 13 13 13 13 13 0 0 0 0 0 0 0
0 0 0 0 0 0 0 51 51 51 51 51 51 51 51 51 51 51 0 0 0 0 0 0 0
0 0 0 0 0 0 0 1 1 1 1 1 1 1 1 1 1 1 0 0 0 0 0 0 0
0 0 0 0 0 0 0 2 3 2 3 2 3 2 3 2 3 2 0 0 0 0 0 0 0
0 0 0 0 0 0 0 52 53 52 53 52 53 52 53 52 53 52 0 0 0 0 0 0 0
0 0 0 0 0 0 0 0 0 0 0 0 0 0 0 0 0 0 0 0 0 0 0 0 0
0 0 0 0 0 0 0 0 0 0 0 0 0 0 0 0 0 0 0 0 0 0 0 0 0
0 0 0 0 0 0 0 0 0 0 0 0 0 0 0 0 0 0 0 0 0 0 0 0 0
END_MAP
1 1 1 1 1 1 1 1 1 1 1 1 1 1 1 1 1 1 1 1 1 1 1 1 1
1 1 1 1 1 1 1 1 1 1 1 1 1 1 1 1 1 1 1 1 1 1 1 1 1
1 1 1 1 1 1 1 1 1 1 1 1 1 1 1 1 1 1 1 1 1 1 1 1 1
1 1 1 1 1 1 1 1 1 1 1 1 1 1 1 1 1 1 1 1 1 1 1 1 1
1 1 1 1 1 1 1 1 1 1 1 1 1 1 1 1 1 1 1 1 1 1 1 1 1
1 1 1 1 1 1 1 1 1 1 1 1 1 1 1 1 1 1 1 1 1 1 1 1 1
1 1 1 1 1 1 1 1 1 1 1 1 1 1 1 1 1 1 1 1 1 1 1 1 1
1 1 1 1 1 1 1 1 1 1 1 1 1 1 1 1 1 1 1 1 1 1 1 1 1
1 1 1 1 1 1 1 0 0 0 0 0 0 0 0 0 0 0 1 1 1 1 1 1 1
1 1 1 1 1 1 1 0 0 0 0 0 0 0 0 0 0 0 1 1 1 1 1 1 1
1 1 1 1 1 1 1 0 0 0 0 0 0 0 0 0 0 0 1 1 1 1 1 1 1
1 1 1 1 1 1 1 0 0 0 0 0 0 0 0 0 0 0 1 1 1 1 1 1 1
1 1 1 1 1 1 1 0 0 0 0 0 0 0 0 0 0 0 1 1 1 1 1 1 1
1 1 1 1 1 1 1 1 1 0 0 0 0 0 0 0 1 1 1 1 1 1 1 1 1
1 1 1 1 1 1 1 1 1 0 0 0 0 0 0 0 1 1 1 1 1 1 1 1 1
1 1 1 1 1 1 1 1 1 0 0 0 0 0 0 0 1 1 1 1 1 1 1 1 1
1 1 1 1 1 1 1 1 1 0 0 0 0 0 0 0 1 1 1 1 1 1 1 1 1
1 1 1 1 1 1 1 0 0 0 0 0 0 0 0 0 0 0 1 1 1 1 1 1 1
1 1 1 1 1 1 1 0 0 0 0 0 0 0 0 0 0 0 1 1 1 1 1 1 1
1 1 1 1 1 1 1 0 0 0 0 0 0 0 0 0 0 0 1 1 1 1 1 1 1
1 1 1 1 1 1 1 0 0 0 0 0 0 0 0 0 0 0 1 1 1 1 1 1 1
1 1 1 1 1 1 1 0 0 0 0 0 0 0 0 0 0 0 1 1 1 1 1 1 1
1 1 1 1 1 1 1 0 0 0 0 0 0 0 0 0 0 0 1 1 1 1 1 1 1
1 1 1 1 1 1 1 1 1 1 1 1 1 1 1 1 1 1 1 1 1 1 1 1 1
1 1 1 1 1 1 1 1 1 1 1 1 1 1 1 1 1 1 1 1 1 1 1 1 1
1 1 1 1 1 1 1 1 1 1 1 1 1 1 1 1 1 1 1 1 1 1 1 1 1
1 1 1 1 1 1 1 1 1 1 1 1 1 1 1 1 1 1 1 1 1 1 1 1 1
1 1 1 1 1 1 1 1 1 1 1 1 1 1 1 1 1 1 1 1 1 1 1 1 1
1 1 1 1 1 1 1 1 1 1 1 1 1 1 1 1 1 1 1 1 1 1 1 1 1
1 1 1 1 1 1 1 1 1 1 1 1 1 1 1 1 1 1 1 1 1 1 1 1 1
END_COLLISION_MAP
MAP_NEXT_NPC
12 13 0 1
res/npcsprite/npcSprite13.png
Hello challenger! Welcome to the Pokemon UET Challenge!
You see, whether you are starting this challenge for the first time or the nth time,...
...I will always be your first opponent!
So get ready and good luck.
I could be a cake walk, but could also be your toughest opponent yet!
NPC_PREBATTLE_END
Pokemon Trainer Dust
res/battleassets/opponentSprites/opponentSprite10.png
Congratulations on defeating me!
Go on! Advance to the next room and enjoy the fierceness of the Pokemon UET Challenge.
I might not see you again in the challenge, but best of luck to you!
NPC_DIALOGUE_END
NPC_DATA_STOP
WARP_DATA_STOP
INTER_DATA_STOP