0
38 55
0 0 0 0 0 0 0 0 0 0 0 0 0 0 0 0 0 0 0 0 0 0 0 0 0 0 0 0 0 0 0 0 0 0 0 0 0 0 0 0 0 0 0 0 0 0 0 0 0 0 0 0 0 0 0
0 0 0 0 0 0 0 0 0 0 0 0 0 0 0 0 0 0 0 0 0 0 0 0 0 0 0 0 0 0 0 0 0 0 0 0 0 0 0 0 0 0 0 0 0 0 0 0 0 0 0 0 0 0 0
1 1 1 1 1 1 1 1 1 1 1 1 1 1 1 1 1 1 1 1 1 1 1 1 1 1 1 1 1 1 1 1 1 1 1 1 1 1 1 1 1 1 1 1 1 1 1 1 1 1 1 0 0 0 0
2 2 2 2 2 2 2 2 2 2 2 2 2 2 2 2 2 2 2 2 2 2 2 2 2 2 2 2 2 2 2 2 2 2 2 2 2 2 2 2 2 2 2 2 2 2 2 2 2 2 2 3 0 0 0
4 4 4 4 4 4 4 4 5 6 4 4 4 5 6 4 4 4 4 4 4 4 4 4 4 4 4 4 4 4 4 4 4 4 4 4 4 4 4 4 4 4 4 4 4 4 4 4 4 5 2 3 0 0 0
2 2 2 2 2 2 2 2 7 2 2 8 2 2 9 2 10 11 12 10 11 12 2 2 2 2 2 2 13 14 14 14 14 14 14 14 14 15 2 2 2 2 2 2 2 16 17 16 17 7 2 3 0 0 0
18 18 18 18 18 18 19 20 7 2 21 22 23 2 9 10 11 12 10 11 12 24 25 25 25 25 25 25 26 27 27 27 27 27 27 27 27 28 25 25 25 25 25 25 29 30 31 30 31 7 2 3 0 0 0
32 32 32 32 32 32 33 34 7 2 3 0 35 2 9 10 11 12 10 11 12 36 37 38 39 39 39 39 40 41 41 41 41 41 41 41 41 42 39 39 39 39 43 37 44 16 17 16 17 7 2 3 0 0 0
32 32 32 32 32 32 32 45 7 2 3 0 35 2 9 10 11 12 10 11 12 36 2 46 47 47 47 47 48 49 49 49 49 49 49 49 49 50 47 47 47 47 51 2 44 30 31 30 31 7 2 3 0 0 0
32 32 32 32 32 32 32 45 7 2 3 0 35 2 9 2 2 2 10 11 12 36 37 46 47 47 47 47 47 47 47 47 47 47 47 47 47 47 47 47 47 47 51 37 44 16 17 16 17 7 2 3 0 0 0
32 32 32 32 32 32 32 45 7 2 3 0 35 2 9 2 2 2 10 11 12 36 2 46 47 47 47 47 47 47 47 47 47 47 47 47 47 47 47 47 47 47 51 2 44 30 31 30 31 7 2 3 0 0 0
32 32 32 32 32 32 32 45 7 2 3 0 35 2 52 4 5 2 10 11 12 36 37 46 47 47 47 47 47 47 47 47 47 47 47 47 47 47 47 47 47 47 51 37 44 16 17 16 17 7 2 3 0 0 0
32 32 32 32 32 32 32 45 7 2 3 0 35 2 2 2 2 2 10 11 12 36 2 53 54 54 54 54 54 54 54 54 54 54 54 54 54 54 54 54 54 54 55 2 44 30 31 30 31 7 2 3 0 0 0
32 32 32 32 32 32 32 45 7 2 3 0 35 2 6 4 5 2 10 11 12 36 37 56 57 56 57 56 57 56 57 56 57 56 57 56 57 56 57 56 57 56 57 37 44 16 17 16 17 7 2 3 0 0 0
32 32 32 32 32 32 32 45 7 2 3 0 35 2 9 10 11 12 10 11 12 36 2 58 59 59 59 59 59 59 59 59 59 59 59 59 59 59 59 59 59 59 60 2 44 30 31 30 31 7 2 3 0 0 0
32 32 32 32 32 32 32 45 7 2 3 0 35 2 9 10 11 12 10 11 12 36 37 53 54 54 54 54 54 54 54 61 62 63 64 54 54 54 54 54 54 54 55 37 44 16 17 16 17 7 2 3 0 0 0
32 32 32 32 32 32 32 45 7 2 3 0 35 2 9 2 2 16 17 16 17 36 2 56 57 56 57 56 57 56 57 65 66 67 68 56 57 56 57 56 57 56 57 2 44 30 31 30 31 7 2 3 0 0 0
32 32 32 32 32 69 70 71 7 2 3 0 35 2 9 2 2 30 31 30 31 36 37 58 59 59 59 59 59 59 59 72 73 73 74 59 59 59 59 59 59 59 60 37 44 16 17 16 17 7 2 3 0 0 0
32 32 32 32 32 45 75 76 7 2 3 0 35 2 9 2 2 16 17 16 17 77 78 78 78 78 78 78 79 80 80 80 80 80 80 80 80 81 78 78 78 78 78 78 82 30 31 30 31 7 2 3 0 0 0
32 32 32 32 32 45 75 76 83 2 3 0 35 2 52 4 5 30 31 30 31 2 2 10 11 12 2 2 84 80 80 80 80 80 80 80 80 85 2 2 86 87 88 2 2 2 2 2 2 7 2 3 0 0 0
32 32 32 32 32 45 89 90 2 2 3 0 35 2 2 2 2 2 2 2 2 2 2 2 2 2 2 2 2 2 2 2 2 2 2 2 2 91 2 2 92 93 94 2 2 2 2 2 2 7 2 3 0 0 0
32 32 32 32 32 45 95 96 22 22 0 0 0 22 22 22 22 22 22 22 22 22 22 22 22 22 22 22 22 22 22 22 22 22 22 22 22 22 22 22 22 22 22 22 22 22 22 23 2 7 2 3 0 0 0
32 32 32 32 32 45 97 98 0 0 0 0 0 0 0 0 0 0 0 0 0 0 0 0 0 0 0 0 0 0 0 0 0 0 0 0 0 0 0 0 0 0 0 0 0 0 0 35 8 7 2 3 0 0 0
32 32 32 32 32 45 99 100 1 1 0 0 0 1 1 1 1 1 1 1 1 1 1 1 1 1 1 1 1 1 1 1 1 1 1 1 1 1 1 1 1 1 1 1 1 1 1 101 2 7 2 3 0 0 0
32 32 32 32 32 102 18 103 2 2 3 0 35 2 2 2 2 2 2 2 2 2 2 2 2 2 2 2 2 2 2 2 2 2 2 2 2 2 2 2 2 2 2 2 2 2 2 2 2 7 2 3 0 0 0
32 32 32 32 32 32 32 45 5 2 3 0 35 2 6 4 4 4 4 4 4 4 4 4 4 4 4 4 4 4 4 4 4 4 4 4 4 4 4 4 4 4 4 4 4 4 4 4 4 83 2 3 0 0 0
32 32 32 32 32 32 32 45 7 2 3 0 35 2 9 2 2 2 2 2 2 2 2 2 2 2 2 2 2 2 2 2 2 2 2 2 2 2 2 2 2 2 2 2 2 2 2 2 2 7 2 3 0 0 0
32 32 32 32 32 32 32 45 7 2 3 0 35 2 9 2 104 105 106 107 108 104 105 106 107 108 104 105 106 107 108 104 105 106 107 108 104 105 106 107 108 104 105 106 107 108 104 105 2 7 2 3 0 0 0
32 32 32 32 32 32 32 45 7 2 3 0 35 2 9 2 109 110 111 112 113 109 110 111 112 113 109 110 111 112 113 109 110 111 112 113 109 110 111 112 113 109 110 111 112 113 109 110 2 7 2 3 0 0 0
32 32 32 32 32 32 32 45 7 2 3 0 35 2 9 2 109 110 114 115 116 109 110 114 115 116 109 110 114 115 116 109 110 114 115 116 109 110 114 115 116 109 110 114 115 116 109 110 2 7 2 3 0 0 0
117 117 117 117 117 117 117 118 7 2 3 0 35 2 9 2 109 119 120 120 120 119 119 120 120 120 119 119 120 120 120 119 119 120 120 120 119 119 120 120 120 119 119 120 120 120 119 110 2 7 2 3 0 0 0
121 122 121 122 121 122 121 76 7 2 123 1 101 2 9 2 109 119 124 124 124 119 119 124 124 124 119 119 124 124 124 119 119 124 124 124 119 119 124 124 124 119 119 124 124 124 119 110 2 7 2 3 0 0 0
121 122 121 122 121 122 121 76 7 2 2 8 2 2 9 2 109 110 106 107 108 109 110 106 107 108 109 110 106 107 108 109 110 106 107 108 109 110 106 107 108 109 110 106 107 108 109 110 2 7 2 3 0 0 0
121 122 121 122 121 122 121 76 7 6 4 4 4 5 9 2 109 110 111 112 113 109 110 111 112 113 109 110 111 112 113 109 110 111 112 113 109 110 111 112 113 109 110 111 112 113 109 110 2 7 2 3 0 0 0
125 125 125 125 125 125 125 90 7 2 2 2 2 2 9 2 126 127 114 115 116 126 127 114 115 116 126 127 114 115 116 126 127 114 115 116 126 127 114 115 116 126 127 114 115 116 126 127 2 7 2 3 0 0 0
2 2 2 2 2 2 2 2 7 2 2 2 2 2 9 2 2 2 2 2 2 2 2 2 2 2 2 2 2 2 2 2 2 2 2 2 2 2 2 2 2 2 2 2 2 2 2 2 2 7 2 3 0 0 0
4 4 4 4 4 4 4 4 83 2 2 2 2 2 6 4 4 4 4 4 4 4 4 4 4 4 4 4 4 4 4 4 4 4 4 4 4 4 4 4 4 4 4 4 4 4 4 4 4 83 2 3 0 0 0
2 2 2 2 2 2 2 2 2 2 2 2 2 2 2 2 2 2 2 2 2 2 2 2 2 2 2 2 2 2 2 2 2 2 2 2 2 2 2 2 2 2 2 2 2 2 2 2 2 2 2 3 0 0 0
END_MAP
0 0 0 0 0 0 0 0 0 0 0 0 0 0 0 0 0 0 0 0 0 0 0 0 0 0 0 0 0 0 0 0 0 0 0 0 0 0 0 0 0 0 0 0 0 0 0 0 0 0 0 0 0 0 0
0 0 0 0 0 0 0 0 0 0 0 0 0 0 0 0 0 0 0 0 0 0 0 0 0 0 0 0 0 0 0 0 0 0 0 0 0 0 0 0 0 0 0 0 0 0 0 0 0 0 0 0 0 0 0
0 0 0 0 0 0 0 0 0 0 0 0 0 0 0 0 0 0 0 0 0 0 0 0 0 0 0 0 0 0 0 0 0 0 0 0 0 0 0 0 0 0 0 0 0 0 0 0 0 0 0 0 0 0 0
0 0 0 0 0 0 0 0 0 0 0 0 0 0 0 0 0 0 0 0 0 0 0 0 0 0 0 0 0 0 0 0 0 0 0 0 0 0 0 0 0 0 0 0 0 0 0 0 0 0 0 0 0 0 0
1 1 1 1 1 1 1 1 1 1 1 1 1 1 1 1 1 1 1 1 1 1 1 1 1 1 1 1 1 1 1 1 1 1 1 1 1 1 1 1 1 1 1 1 1 1 1 1 1 1 0 0 0 0 0
1 1 1 1 1 1 1 1 1 0 0 3 0 0 1 1 1 1 1 1 1 1 1 1 1 1 1 1 1 1 1 1 1 1 1 1 1 1 1 1 1 1 1 1 1 1 1 1 1 1 0 0 0 0 0
1 1 1 1 1 1 1 1 1 0 0 0 0 0 1 1 1 1 1 1 1 1 0 0 0 0 0 0 0 1 1 1 1 1 1 1 1 0 0 0 0 0 0 0 1 1 1 1 1 1 0 0 0 0 0
1 1 1 1 1 1 1 1 1 0 0 0 0 0 1 1 1 1 1 1 1 1 0 1 1 1 1 1 1 1 1 1 1 1 1 1 1 1 1 1 1 1 1 0 1 1 1 1 1 1 0 0 0 0 0
1 1 1 1 1 1 1 1 1 0 0 0 0 0 1 1 1 1 1 1 1 1 0 1 1 1 1 1 1 1 1 1 1 1 1 1 1 1 1 1 1 1 1 0 1 1 1 1 1 1 0 0 0 0 0
1 1 1 1 1 1 1 1 1 0 0 0 0 0 1 0 0 0 1 1 1 1 0 1 1 1 1 1 1 1 1 1 1 1 1 1 1 1 1 1 1 1 1 0 1 1 1 1 1 1 0 0 0 0 0
1 1 1 1 1 1 1 1 1 0 0 0 0 0 1 0 0 0 1 1 1 1 0 1 1 1 1 1 1 1 1 1 1 1 1 1 1 1 1 1 1 1 1 0 1 1 1 1 1 1 0 0 0 0 0
1 1 1 1 1 1 1 1 1 0 0 0 0 0 1 1 1 0 1 1 1 1 0 1 1 1 1 1 1 1 1 1 1 1 1 1 1 1 1 1 1 1 1 0 1 1 1 1 1 1 0 0 0 0 0
1 1 1 1 1 1 1 1 1 0 0 0 0 0 0 0 0 0 1 1 1 1 0 1 1 1 1 1 1 1 1 1 1 1 1 1 1 1 1 1 1 1 1 0 1 1 1 1 1 1 0 0 0 0 0
1 1 1 1 1 1 1 1 1 0 0 0 0 0 1 1 1 0 1 1 1 1 0 1 1 1 1 1 1 1 1 1 1 1 1 1 1 1 1 1 1 1 1 0 1 1 1 1 1 1 0 0 0 0 0
1 1 1 1 1 1 1 1 1 0 0 0 0 0 1 1 1 1 1 1 1 1 0 1 1 1 1 1 1 1 1 1 1 1 1 1 1 1 1 1 1 1 1 0 1 1 1 1 1 1 0 0 0 0 0
1 1 1 1 1 1 1 1 1 0 0 0 0 0 1 1 1 1 1 1 1 1 0 1 1 1 1 1 1 1 1 1 1 1 1 1 1 1 1 1 1 1 1 0 1 1 1 1 1 1 0 0 0 0 0
1 1 1 1 1 1 1 1 1 0 0 0 0 0 1 0 0 1 1 1 1 1 0 1 1 1 1 1 1 1 1 1 2 2 1 1 1 1 1 1 1 1 1 0 1 1 1 1 1 1 0 0 0 0 0
1 1 1 1 1 1 1 1 1 0 0 0 0 0 1 0 0 1 1 1 1 1 0 1 1 1 1 1 1 1 1 1 0 0 1 1 1 1 1 1 1 1 1 0 1 1 1 1 1 1 0 0 0 0 0
1 1 1 1 1 1 1 1 1 0 0 0 0 0 1 0 0 1 1 1 1 1 1 1 1 1 1 1 1 0 0 0 0 0 0 0 0 1 1 1 1 1 1 1 1 1 1 1 1 1 0 0 0 0 0
1 1 1 1 1 1 1 1 1 0 0 0 0 0 1 1 1 1 1 1 1 0 0 1 1 1 0 0 1 0 0 0 0 0 0 0 0 1 0 0 3 1 3 0 0 0 0 0 0 1 0 0 0 0 0
1 1 1 1 1 1 1 1 0 0 0 0 0 0 0 0 0 0 0 0 0 0 0 0 0 0 0 0 0 0 0 0 0 0 0 0 0 3 0 0 3 3 3 0 0 0 0 0 0 1 0 0 0 0 0
1 1 1 1 1 1 2 0 0 0 0 0 0 0 0 0 0 0 0 0 0 0 0 0 0 0 0 0 0 0 0 0 0 0 0 0 0 0 0 0 0 0 0 0 0 0 0 0 0 1 0 0 0 0 0
1 1 1 1 1 1 2 0 0 0 0 0 0 0 0 0 0 0 0 0 0 0 0 0 0 0 0 0 0 0 0 0 0 0 0 0 0 0 0 0 0 0 0 0 0 0 0 0 3 1 0 0 0 0 0
1 1 1 1 1 1 2 0 0 0 0 0 0 0 0 0 0 0 0 0 0 0 0 0 0 0 0 0 0 0 0 0 0 0 0 0 0 0 0 0 0 0 0 0 0 0 0 0 0 1 0 0 0 0 0
1 1 1 1 1 1 1 1 0 0 0 0 0 0 0 0 0 0 0 0 0 0 0 0 0 0 0 0 0 0 0 0 0 0 0 0 0 0 0 0 0 0 0 0 0 0 0 0 0 1 0 0 0 0 0
1 1 1 1 1 1 1 1 1 0 0 0 0 0 1 1 1 1 1 1 1 1 1 1 1 1 1 1 1 1 1 1 1 1 1 1 1 1 1 1 1 1 1 1 1 1 1 1 1 1 0 0 0 0 0
1 1 1 1 1 1 1 1 1 0 0 0 0 0 1 0 0 0 0 0 0 0 0 0 0 0 0 0 0 0 0 0 0 0 0 0 0 0 0 0 0 0 0 0 0 0 0 0 0 1 0 0 0 0 0
1 1 1 1 1 1 1 1 1 0 0 0 0 0 1 0 0 0 1 1 1 0 0 1 1 1 0 0 1 1 1 0 0 1 1 1 0 0 1 1 1 0 0 1 1 1 0 0 0 1 0 0 0 0 0
1 1 1 1 1 1 1 1 1 0 0 0 0 0 1 0 0 0 1 1 1 0 0 1 1 1 0 0 1 1 1 0 0 1 1 1 0 0 1 1 1 0 0 1 1 1 0 0 0 1 0 0 0 0 0
1 1 1 1 1 1 1 1 1 0 0 0 0 0 1 0 0 0 1 1 1 0 0 1 1 1 0 0 1 1 1 0 0 1 1 1 0 0 1 1 1 0 0 1 1 1 0 0 0 1 0 0 0 0 0
1 1 1 1 1 1 1 1 1 0 0 0 0 0 1 0 0 0 0 0 0 0 0 0 0 0 0 0 0 0 0 0 0 0 0 0 0 0 0 0 0 0 0 0 0 0 0 0 0 1 0 0 0 0 0
1 1 1 1 1 1 1 1 1 0 0 0 0 0 1 0 0 0 0 0 0 0 0 0 0 0 0 0 0 0 0 0 0 0 0 0 0 0 0 0 0 0 0 0 0 0 0 0 0 1 0 0 0 0 0
1 1 1 1 1 1 1 1 1 0 0 3 0 0 1 0 0 0 1 1 1 0 0 1 1 1 0 0 1 1 1 0 0 1 1 1 0 0 1 1 1 0 0 1 1 1 0 0 0 1 0 0 0 0 0
1 1 1 1 1 1 1 1 1 1 1 1 1 1 1 0 0 0 1 1 1 0 0 1 1 1 0 0 1 1 1 0 0 1 1 1 0 0 1 1 1 0 0 1 1 1 0 0 0 1 0 0 0 0 0
1 1 1 1 1 1 1 1 1 0 0 0 0 0 1 0 0 0 1 1 1 0 0 1 1 1 0 0 1 1 1 0 0 1 1 1 0 0 1 1 1 0 0 1 1 1 0 0 0 1 0 0 0 0 0
1 1 1 1 1 1 1 1 1 0 0 0 0 0 1 0 0 0 0 0 0 0 0 0 0 0 0 0 0 0 0 0 0 0 0 0 0 0 0 0 0 0 0 0 0 0 0 0 0 1 0 0 0 0 0
1 1 1 1 1 1 1 1 1 0 0 0 0 0 1 1 1 1 1 1 1 1 1 1 1 1 1 1 1 1 1 1 1 1 1 1 1 1 1 1 1 1 1 1 1 1 1 1 1 1 0 0 0 0 0
0 0 0 0 0 0 0 0 0 0 0 0 0 0 0 0 0 0 0 0 0 0 0 0 0 0 0 0 0 0 0 0 0 0 0 0 0 0 0 0 0 0 0 0 0 0 0 0 0 0 0 0 0 0 0
END_COLLISION_MAP
MAP_NEXT_NPC
16 10 1 0
res/npcsprite/npcSprite2.png
Stop right there kiddo!
I know exactly what vicious crime you are planning to commit!
You are trying to steal these bikes aren't you?
Well, not on my watch kiddo. You see, I have chained all of the vehicles solid here.
Have fun trying to steal them, thief! They are all MINE!
NPC_DIALOGUE_END
MAP_NEXT_NPC
27 19 0 0
res/npcsprite/npcSprite3.png
Hi I am a veteran Pokemon Trainer!
But for some reason when I take the Pokemon UET Challenge I could hardly last 3 rooms.
NPC_DIALOGUE_END
MAP_NEXT_NPC
19 22 2 0
res/npcsprite/npcSprite9.png
Good morning there student!
Just a reminder, the G2 building is the battle zone.
If you don't have a Pokemon with you, then go to the E3 building.
Pokemons, moves, they got it all covered for you.
And it's all free!
NPC_DIALOGUE_END
NPC_DATA_STOP
WARP_NEXT_TILE
6 21 1 30 21
WARP_NEXT_TILE
6 22 1 30 22
WARP_NEXT_TILE
6 23 1 30 23
WARP_NEXT_TILE
32 16 3 27 34
WARP_NEXT_TILE
33 16 3 28 34
WARP_DATA_STOP
INTER_NEXT_TILE
48 22
Sorry, but access to the rest of VNU is currently unavailable. -Pokemon UET Creators.
INTER_DIALOGUE_END
INTER_NEXT_TILE
11 5
Sorry, but access to the rest of VNU is currently unavailable. -Pokemon UET Creators.
INTER_DIALOGUE_END
INTER_NEXT_TILE
11 32
Sorry, but access to the rest of VNU is currently unavailable. -Pokemon UET Creators.
INTER_DIALOGUE_END
INTER_NEXT_TILE
37 20
G2 Building.
This game's ultimate Pokemon battle zone!
INTER_DIALOGUE_END
INTER_NEXT_TILE
40 19
This boat shell here seems to be a failed graduation thesis project of a CN19 Ocean Technology student.
Apparently he could not defend the refutal against the boat's exterior and building materials.
And in his disappointment he decided to quit the school in favor of the military's marine division.
Well that's a sad ending...
INTER_DIALOGUE_END
INTER_NEXT_TILE
40 20
This boat shell here seems to be a failed graduation thesis project of a CN19 Ocean Technology student.
Apparently he could not defend the refutal against the boat's exterior and building materials.
And in his disappointment he decided to quit the school in favor of the military's marine division.
Well that's a sad ending...
INTER_DIALOGUE_END
INTER_NEXT_TILE
41 20
This boat shell here seems to be a failed graduation thesis project of a CN19 Ocean Technology student.
Apparently he could not defend the refutal against the boat's exterior and building materials.
And in his disappointment he decided to quit the school in favor of the military's marine division.
Well that's a sad ending...
INTER_DIALOGUE_END
INTER_NEXT_TILE
42 19
This boat shell here seems to be a failed graduation thesis project of a CN19 Ocean Technology student.
Apparently he could not defend the refutal against the boat's exterior and building materials.
And in his disappointment he decided to quit the school in favor of the military's marine division.
Well that's a sad ending...
INTER_DIALOGUE_END
INTER_NEXT_TILE
42 20
This boat shell here seems to be a failed graduation thesis project of a CN19 Ocean Technology student.
Apparently he could not defend the refutal against the boat's exterior and building materials.
And in his disappointment he decided to quit the school in favor of the military's marine division.
Well that's a sad ending...
INTER_DIALOGUE_END
INTER_DATA_STOP